.........................................................................
.........................................................................
.........................................................................
.........................................................................
.........................................................................
.........................................................................
.........................................................................
.............................................##..........................
...........................................##.............%%^............
.............................#...........##....###........%%^............
............................###........##.................%%^............
...........................#####.....##...................%%^............
$$$$$$$$$##########$$########################################$$$$$$$$$$$$
$$$$$$$$$##########$$########################################$$$$$$$$$$$$
$$$$$$$$$##########$$########################################$$$$$$$$$$$$
$$$$$$$$$##########$$########################################$$$$$$$$$$$$
$$$$$$$$$##########$$########################################$$$$$$$$$$$$
$$$$$$$$$##########$$########################################$$$$$$$$$$$$
$$$$$$$$$##########$$########################################$$$$$$$$$$$$

