...............................................................................
...............................................................................
...............................................................................
...............................................................................
...............................................................................
...............................................................................
...............................................................................
...............................................................................
...............................................................................
...............................................................................
...............................................................................
.............................................#.................................
#####################################..########################################
#####################################..########################################
#####################################..########################################
#####################################..########################################
#####################################..########################################
#####################################..########################################
#####################################..########################################

