...............................................................................
...............................................................................
...............................................................................
...............................................................................
...............................................................................
...............................................................................
...............................................................................
.............................................##...........%%^..................
...........................................##.............%%^..................
.............................#...........##....###....###.###..................
............................###........##..........##.....###..................
...........................#####.....##...................###..................
$$$$$$$$$##########$$##########################&&&&&&&&&&&###$$$$$$$$$$$$$$$$$$
$$$$$$$$$##########$$########################################$$$$$$$$$$$$$$$$$$
$$$$$$$$$##########$$########################################$$$$$$$$$$$$$$$$$$
$$$$$$$$$##########$$########################################$$$$$$$$$$$$$$$$$$
$$$$$$$$$##########$$########################################$$$$$$$$$$$$$$$$$$
$$$$$$$$$##########$$########################################$$$$$$$$$$$$$$$$$$
$$$$$$$$$##########$$########################################$$$$$$$$$$$$$$$$$$

