.........................................................................
.........................................................................
.........................................................................
.........................................................................
.........................................................................
.........................................................................
.........................................................................
.........................................................................
..........................................................%%^............
.............................#............................%%^............
............................###...........................%%^............
...........................#####..........................%%^............
$$$$$$$$$##########$$########################################$$$$$$$$$$$$
$$$$$$$$$##########$$########################################$$$$$$$$$$$$
$$$$$$$$$##########$$########################################$$$$$$$$$$$$
$$$$$$$$$##########$$########################################$$$$$$$$$$$$
$$$$$$$$$##########$$########################################$$$$$$$$$$$$
$$$$$$$$$##########$$########################################$$$$$$$$$$$$
$$$$$$$$$##########$$########################################$$$$$$$$$$$$

