................................................................................
................................................................................
................................................................................
................................................................................
................................................................................
................................................................................
................................................................................
................................................##..........%%^.................
..............................................##............%%^.................
.............................#...#...#......##....#.#....##.###.................
............................###...........##....#....#.#....###.................
...........................#####........##....#.............###.................
$$$$$$$$$##########$$###########################&&&&&&&&&&&&###$$$$$$$$$$$$$$$$$
$$$$$$$$$##########$$##########################################$$$$$$$$$$$$$$$$$
$$$$$$$$$##########$$##########################################$$$$$$$$$$$$$$$$$
$$$$$$$$$##########$$##########################################$$$$$$$$$$$$$$$$$
$$$$$$$$$##########$$##########################################$$$$$$$$$$$$$$$$$
$$$$$$$$$##########$$##########################################$$$$$$$$$$$$$$$$$
$$$$$$$$$##########$$##########################################$$$$$$$$$$$$$$$$$

